Level 33
   #######
  ##     ##
  #  ###  #
  # ## $  ####
  # # .#   $.####
  # # * *###.$  #
  # # *#   ### #####
  # # @ * *  # #   #
  # #  ### #*#  *  #
  # ## #  * *.# # #######
  # #  #     ....$  $   #
  # # ## $# $####$      #
###*   *     #    #######
#   ########## ####
#              #
##  ############
 ####

Level 34
            #####
            # ..########
            # ......#  #
            #.. ##$$  $#
         #####.##   $  #
         #  ....# $  $$#
##### ## #  .. .#$  $  #
#   #    # ##.###  $$ $###
#   ###  # ## #  $  #    #
# @   #### #  # # ###$ # #
#             #  $    $  #
#   ####      ### ####$$##
#  ##  ####     #       #
#  #      ##    ######  #
####       ##     # # $ #
            ##    # #   #
             ###### #####

Level 35
 #####
 #   #
## # #####
#    ##  #######
# #     $      ####
#   #### $  $$ #  #
#####  # $$$ $ #$ #
       # $  $ $ $ ######
     ###$   #$ $  $    #
     # $ $$      ### @ ##
     #  $ $$$$####...   #
     #  $     $ #. .#...#
     ### $$$$   ......  #
       #      ##..#.....#
       ###### ##.....####
            #   .....#   #
            ##########
